19 19
1111111111111111111
1002220w000q0020221
1012101010121210101
12q2022022202022021
1210121q10101010101
100222002q0202A0001
121q101010101010101
10022020200w0002001
1010101010121010101
1q20202002220020001
1010101010101010101
10w2202020000202001
1012101010101012101
1000202220q20200001
101z101010121010101
1022000020200000001
10121012101010101w1
100202002w000200201
1111111111111111111

