21 21
111111111111111111111
10022220q0020200200q1
101w12101010101010121
12220q0202202002A0201
101210101010101210101
1q2202022200200200021
101210101010101010101
1020q202022002000e001
101210121010101010121
1020wqq00200020000001
101010101010101010121
1x02002020q0000q00q01
101010101010101010121
120002200200202000001
121010101010101010101
120000000020000000001
101010101010101010101
100w0002002000w002eq1
121010101010101010101
10w0020002000e20w0001
111111111111111111111