25 17
1111111111111111111111111
1002020200002020c00200e01
1010101210101210101010121
10000w2000020202020020201
1212121010101010101010121
102q2020200w00q2000020001
1210101010101010101010121
10q0202000200200t00020001
1212101010101010101010121
100q00200e000t02020020201
1010101010101010101010101
10020q022000202Aq20200001
1010101210101010101010101
1200q02000t002000000w0q01
10101010101e101010101q101
100202t000200e02000q000e1
1111111111111111111111111

