35 17
11111111111111111111111111111111111
10020t00200q02000200w00q00e0022eee1
10121010101212121012101010101012101
1022q2020020020022222002020020020w1
10121010101010101010101010121010101
100q200020020200202000q02002w0t2001
12101010101010101010101010101010101
1220202020020202002020202020wq02r01
1210101012101010101010101010101t101
1w0q2200q22002t0q202020200q00202201
1q101012121010101010101010101010101
1t0q00202020002200020w02020q0q00001
1t12101w101010101010101010101010101
12222222000000200200w000z020002ee21
121A1210101010101010101010121010121
10q0200202ee2e22220200e00r0r2r2r2r1
11111111111111111111111111111111111
