13 31
1111111111111
10020q002e001
1010121010101
120y02020e001
1010101010101
102000y002001
1010101010101
12000200200t1
10121010101r1
1020yc0202001
1012101010101
1y0020e020001
1010101010101
10002020q0201
10101q1010101
120t002000201
1010101010101
1000w0020w001
101t10101w101
10qq0200y0021
1010101010121
1002y0020y0q1
1010101010101
120w0t20y0Ay1
1e10101010101
102020y002001
101010121t101
1y0200e2e0er1
101010101e1r1
10rrry02e2rr1
1111111111111


