35 23
11111111111111111111111111111111111
10020t020w0w02020000y00Q00020020201
10121212101010101010101012101012101
102q02020t002000q002t0e0020200220y1
12121210101010101010101010101010101
1Q0Q2020202e02002002002000t0yyQQ021
12121212101010101010101010101010101
102020202q0Q00t00y00020000200202001
1212101y101010101010121010101010101
10220qQ0Q0202002000200020q0y0220t21
12101010101r101010101010101r1010101
1200Q200Q0r0t0r00020w000w0r0q00Qe01
10121010101010101010101010101010101
100200220t200002r002000y00Q002r00r1
101010121y1010101010101010101210121
10002x00200020002002002002A02000021
10101010101010101010101010101010121
100200y0y0e00202000t00er0y000Q0e0e1
10101010101010101010101010101210101
10000w00020w0e02002002000t2rQe0e001
101010101010101010101w1210121010101
10q000e002002000200q0020t020000e001
11111111111111111111111111111111111

