33 27
111111111111111111111111111111111
10022u2q22w20w0202002000ru0r00e21
101u101t1u1y1010101210101010101u1
12u2u22QqQ0020202yuu020000r00e0u1
1212101210101010101010101010101u1
1u2qQy200y00200u0yu0y0000y00000u1
10101t121012101w10101010101010121
1uu20t0rr2e00u20w02w002u000y00021
1210101010101010101012101010101u1
12e20e000u00200z020w2u0w000r00021
1u101012101u1010101012121010101u1
1e00022000Qu020u00202uu00r00u0001
1e101010101010101u101210101010101
1u00Q002020u02u0002002u00Q0000qq1
1210101r1010101010101010101010101
12u000r002u00q00q00200202000020q1
1210101010101u1010101010101010101
12r00200qr00q2Q000y00u020u0000uu1
121y1210101Q1010101010101010101u1
1u20u00u20Q0Q2002000202020w000w01
1u1010101010101010101010101010121
100u0u0200e202u0tw00u00u00t0020u1
1u1u101u10101210101010101012101u1
122000220y020eu00u020u0w0e20w2021
12101010101012101e1u121012121t1t1
1w202e0e20e0t0ut02eueee0002ttttt1
111111111111111111111111111111111
